4 13 31
###############################
#p  x * **    *   3   4       #
# #f# #b# #*# # # # # # #*# # #
#*   * *    *b* *   **        #
# #*# # #*#*#*#*#x# #1#f# #*# #
#        * 4 *2*    *   *     #
# #s# #*# # # # # #s# # # # # #
#      ** * *  *   * ** 3 *   #
#*#b# # # # # # # # # #*# # #*#
#x*    * **    ** ***     1   #
# # # # # # # # # # # # # #*# #
#    * 5   *        *    **  3#
###############################