2 13 31
###############################
#p  x*   2   *  ** * *     *  #
# # #b# #*# # #*# # # # # #*# #
#   *  **   x**     ***   *   #
# #*#s# # # # # #b# # # # # #*#
#   1       *     **  1     **#
#f# #*# # # # # #*#*#*#*# # # #
#   *  x  3   *   * **** *    #
# # # # #*# # # # # # #*# #*# #
#   ****         *2           #
# # # # # # # # # #*# # # # #*#
#    2       * * *****   *    #
###############################