5 13 31
###############################
#p  x*       5 *  ** * *     *#
# # # #b#*# # #*# #s# # # #*# #
#    * * *** **  3   *    **  #
# # # #b#*# #f# # # # #*# #*# #
#   ****         *2           #
# # # # # # #f# # #*#s# # # #*#
#  ** *5  *    2              #
# #*# #b# # #4# #b#1# # # # #*#
#   3  4   *     **      *  **#
# # #*# # # # # #*#*#*#*# # # #
#   * 3      *   * *x* *   4  #
###############################