3 13 31
###############################
#p  x** **    *   2           #
# #*# #b#*#*#*#*# # #1# # #*# #
#        **2*       *f   *    #
# # # # # #*# # # # # # #*# # #
#*****s*    *** * x **    4   #
#*# # #*#*# # # # # # #*# # #*#
# * b  3 * **    ** ***     1 #
# # # #*# # # # # # # # # # # #
#*  3   ** * *  *   * **  *   #
# # # # # # # # # # # # # #*# #
#    *     *        *    **   #
###############################